filename, language, Python, TeX, comment, blank, total
__init__.py, Python, 0, 0, 2, 1, 3
__main__.py, Python, 111, 0, 58, 13, 182
rivet_chk.py, Python, 39, 0, 27, 22, 88
rivet_lib.py, Python, 185, 0, 92, 26, 303
rivet_pdf.sty, TeX, 0, 46, 11, 1, 58
rivet_reprt.py, Python, 137, 0, 50, 23, 210
rivet_rst.py, Python, 675, 0, 231, 42, 948
rivet_unit.py, Python, 74, 0, 12, 8, 94
rivet_utf.py, Python, 350, 0, 123, 64, 537
unum\__init__.py, Python, 320, 0, 131, 74, 525
unum\units\__init__.py, Python, 2, 0, 1, 2, 5
unum\units\custom\__init__.py, Python, 4, 0, 11, 8, 23
unum\units\others\__init__.py, Python, 31, 0, 7, 3, 41
unum\units\si\__init__.py, Python, 1, 0, 1, 2, 4
unum\units\si\base.py, Python, 150, 0, 7, 16, 173
unum\units\si\derived.py, Python, 27, 0, 6, 4, 37
Total, -, 2106, 46, 770, 309, 3231